7,7,7,7,7,7,7,7,7,7,7,7,7,7,7,7,7,7,7,7,7,7,7,7,7,7,7,7,7,7,7,7,7,7,7,7,7,7,7,7,7,7,7,7,7,7,7,7,7,7,7,7,7,7,7,7,7,7,7,7,7,7,7,7,7,7,7,7,7,7,7,7,7,7,7,7,7,7,7,7,7,7,4,5,5,6,7,7,7,7,7,7,7,7,7,7,7,7,7,7,7,7,7,7,7,7,7,7,7,7,7,7,7,4,5,6,7,7,7,7,7,7,7,7,7,7,7,7,7,7,4,5,5,6,7,7,7,7,7,7,7,7,7,7,7,7,7,7,7,7,7,7,7,7,7,7,7,7,7,7,7,7,7,7,7,7,7,7,7,7,7,7,7,7,7,7,7,7,7,7,7,7,7,7,7,7,7,7,7,7,7,7,7,7,7,7,7,7,7,7,7,7,7,7,7,7,7,7,7,7,7,7,7,7
7,7,7,7,7,7,7,7,7,7,7,7,7,7,7,7,7,7,7,4,5,6,7,7,7,7,7,4,5,5,5,6,7,7,7,7,7,4,5,5,6,7,7,7,7,7,7,7,7,7,7,7,7,7,7,4,5,6,7,7,7,7,7,7,7,7,4,5,6,7,7,7,7,4,5,5,5,6,7,7,7,7,20,21,21,22,7,7,7,7,7,7,7,7,7,7,7,7,7,7,7,4,5,6,7,7,7,7,7,7,7,7,7,20,21,22,7,7,7,7,7,4,5,5,5,6,7,7,7,7,20,21,21,22,7,7,7,7,7,7,7,7,7,7,7,7,7,7,7,7,7,7,7,7,7,7,7,7,7,7,7,7,4,5,6,7,7,7,7,7,7,7,7,7,7,7,7,7,7,4,5,5,6,7,7,7,7,7,7,7,7,7,7,7,7,7,7,12,7,7,7,7,7,7,7,7,7,7,7,7,7,7,7,7
7,7,7,7,7,7,7,4,5,6,7,7,7,7,7,7,7,7,7,20,21,22,7,7,7,7,7,20,21,21,21,22,7,7,7,7,7,20,21,21,22,7,7,7,7,7,7,7,7,7,7,7,7,7,7,20,21,22,7,7,7,7,7,7,7,7,20,21,22,7,7,7,7,20,21,21,21,22,7,7,7,7,7,7,7,7,7,7,7,7,7,7,7,7,7,7,7,7,7,7,7,20,21,22,7,7,7,7,7,7,7,7,7,7,7,7,7,7,7,7,7,20,21,21,21,22,7,7,7,7,7,7,7,7,7,7,7,7,7,7,7,7,7,7,7,7,7,7,7,7,7,4,5,6,7,7,7,7,7,7,7,7,20,21,22,7,7,7,7,7,4,5,5,5,6,7,7,7,7,20,21,21,22,7,7,7,7,7,7,7,7,7,7,7,7,7,7,28,7,4,5,6,7,7,7,7,7,7,7,7,7,7,7,7
7,7,7,7,7,7,7,20,21,22,7,7,7,7,7,7,7,7,7,7,7,7,7,7,7,7,7,7,7,7,7,7,7,7,7,7,7,7,7,7,7,7,7,7,7,7,7,7,7,7,7,7,7,7,7,7,7,7,7,7,7,7,7,7,7,7,7,7,7,7,7,7,7,7,7,7,7,7,2,2,2,2,2,2,2,2,7,7,7,2,2,2,3,7,7,7,7,7,7,7,7,7,7,7,7,7,7,3,7,7,7,7,7,7,7,7,7,7,7,2,2,2,7,7,7,7,2,3,3,2,7,7,7,7,7,7,7,7,7,7,7,7,7,7,7,7,7,7,7,7,7,20,21,22,7,7,7,7,7,7,7,7,7,7,7,7,7,7,7,7,20,21,21,21,22,7,7,7,7,7,7,7,7,7,7,7,7,0,0,7,7,7,7,7,7,7,7,28,7,20,21,22,7,7,7,7,7,7,7,7,7,7,7,7
7,7,7,7,7,7,7,7,7,7,7,7,7,7,7,7,7,7,7,7,7,7,3,7,7,7,7,7,7,7,7,7,7,7,7,7,7,7,7,7,7,7,7,7,7,7,7,7,7,7,7,7,7,7,7,7,7,7,7,7,7,7,7,7,7,7,7,7,7,7,7,7,7,7,7,7,7,7,7,7,7,7,7,7,7,7,7,7,7,7,7,7,7,7,7,7,7,7,7,7,7,7,7,7,7,7,7,7,7,7,7,7,7,7,7,7,7,7,7,7,7,7,7,7,7,7,7,7,7,7,7,7,7,7,7,7,7,7,7,7,7,7,7,7,7,7,7,7,7,7,7,7,7,7,7,7,7,7,7,7,7,7,7,7,7,7,7,7,7,7,7,7,7,7,7,7,7,7,7,7,7,7,7,7,7,7,0,0,0,7,7,7,7,7,7,7,7,28,7,7,7,7,7,7,7,7,7,7,7,7,7,7,7,7
7,7,7,7,7,7,7,7,7,7,7,7,7,7,7,7,7,7,7,7,7,7,7,7,7,7,7,7,7,7,7,7,7,7,7,7,7,7,7,7,7,7,7,7,7,7,7,7,7,7,7,7,7,7,7,7,7,7,7,7,7,7,7,7,7,7,7,7,7,7,7,7,7,7,7,7,7,7,7,7,7,7,7,7,7,7,7,7,7,7,7,7,7,7,7,7,7,7,7,7,7,7,7,7,7,7,7,7,7,7,7,7,7,7,7,7,7,7,7,7,7,7,7,7,7,7,7,7,7,7,7,7,7,7,7,7,7,7,7,7,7,7,7,7,7,7,7,7,7,7,7,7,7,7,7,7,7,7,7,7,7,7,7,7,7,7,7,7,7,7,7,7,7,7,7,7,7,7,7,7,7,7,7,7,7,0,0,0,0,7,7,7,7,7,7,7,7,28,7,7,7,7,7,7,7,7,7,7,7,7,7,7,7,7
7,7,7,7,7,7,7,7,7,7,7,7,7,7,7,7,7,7,7,7,7,7,7,7,7,7,7,7,7,7,7,7,7,7,7,7,7,7,7,7,7,7,7,7,7,7,7,7,7,7,7,7,7,7,7,7,7,7,7,7,7,7,7,7,7,7,7,7,7,7,7,7,7,7,7,7,7,7,7,7,7,7,7,7,7,7,7,7,7,7,7,7,7,7,7,7,7,7,7,7,7,7,7,7,7,7,7,7,7,7,7,7,7,7,7,7,7,7,7,7,7,7,7,7,7,7,7,7,7,7,7,7,7,7,7,7,7,7,7,7,7,7,7,7,7,7,7,7,7,7,7,7,7,7,7,7,7,7,7,7,7,7,7,7,7,7,7,7,7,7,7,7,7,7,7,7,7,7,7,7,7,7,7,7,0,0,0,0,0,7,7,7,7,7,7,7,7,28,7,7,7,7,13,13,13,7,7,7,7,7,7,7,7,7
7,7,7,7,7,7,7,7,7,7,7,7,7,7,7,7,7,7,7,7,7,7,7,7,7,7,7,7,7,7,7,7,7,7,7,7,7,7,7,7,7,7,7,7,7,10,11,7,7,7,7,7,7,7,7,7,10,11,7,7,7,7,7,7,7,7,7,7,7,7,7,7,7,7,7,7,2,3,2,7,7,7,7,7,7,7,7,7,7,7,7,7,2,7,7,7,7,7,2,7,7,7,7,7,3,7,7,3,7,7,3,7,7,7,7,7,2,7,7,7,7,7,7,7,7,7,7,2,2,7,7,7,7,7,7,0,7,7,0,7,7,7,7,7,7,7,7,7,7,7,0,0,7,7,0,7,7,7,7,7,7,7,7,7,7,7,7,2,2,3,2,7,7,7,7,7,7,7,7,7,7,7,7,0,0,0,0,0,0,7,7,7,7,7,7,7,7,28,7,7,7,7,29,16,31,7,7,7,7,7,7,7,7,7
7,7,8,7,7,7,7,7,7,7,7,7,7,7,7,7,7,7,7,7,16,3,16,3,16,7,7,7,7,7,7,7,7,7,7,7,7,7,10,11,7,7,7,7,7,26,27,7,7,8,7,7,7,7,7,7,26,27,7,7,7,7,7,7,7,7,7,7,7,7,7,7,7,7,7,7,7,7,7,7,7,7,7,7,7,7,7,7,7,7,7,7,7,7,7,7,8,7,7,7,7,7,7,7,7,7,7,7,7,7,7,7,7,7,7,7,7,7,7,7,7,7,7,7,7,7,7,7,7,7,7,7,7,7,0,0,7,7,0,0,7,7,7,7,8,7,7,7,7,0,0,0,7,7,0,0,7,7,7,7,7,7,7,7,7,7,7,7,7,7,7,7,7,7,7,7,7,7,7,7,7,7,0,0,0,0,0,0,0,7,7,7,7,8,7,7,7,28,7,7,7,13,15,15,15,13,7,7,7,7,7,7,7,7
7,23,24,25,7,7,7,7,7,7,7,7,7,7,7,7,7,8,7,7,7,7,7,7,7,7,7,7,10,11,7,7,7,7,7,7,7,7,26,27,7,7,7,7,7,26,27,7,23,24,25,7,7,7,7,7,26,27,7,7,7,7,7,7,8,7,7,7,7,7,7,7,7,7,7,7,7,7,7,7,7,7,7,7,7,7,7,7,7,7,7,7,7,7,7,23,24,25,7,7,7,7,7,7,7,7,7,7,7,7,7,8,7,7,7,7,7,7,7,7,7,7,7,7,7,7,7,7,7,7,7,7,7,0,0,0,7,7,0,0,0,7,7,23,24,25,7,7,0,0,0,0,7,7,0,0,0,7,7,7,8,7,10,11,7,7,7,7,7,7,7,7,7,7,7,7,7,7,10,11,7,0,0,0,0,0,0,0,0,7,7,7,23,24,25,7,7,28,7,7,7,16,16,14,16,16,7,7,8,7,7,7,7,7
23,24,9,24,25,7,7,7,7,7,17,18,18,18,18,19,23,24,25,7,7,7,7,17,18,19,7,7,26,27,7,7,7,7,7,7,7,7,26,27,7,17,18,18,19,26,27,23,24,9,24,25,7,7,7,7,26,27,17,18,18,18,19,23,24,25,7,7,7,7,17,18,19,7,7,7,7,7,7,7,7,7,7,7,7,7,7,17,18,18,19,7,7,7,23,24,9,24,25,7,7,7,7,7,7,17,18,18,18,19,23,24,25,7,7,7,7,7,7,7,7,7,7,7,7,7,7,7,7,7,7,7,0,0,0,0,18,18,0,0,0,0,23,24,9,24,25,0,0,0,0,0,7,7,0,0,0,0,19,23,24,25,26,27,7,7,17,18,19,7,7,7,7,7,7,7,7,7,26,27,0,0,0,0,0,0,0,0,0,7,7,23,24,9,24,25,7,0,7,7,7,16,16,30,16,16,19,23,24,25,7,7,7,7
1,1,1,1,1,1,1,1,1,1,1,1,1,1,1,1,1,1,1,1,1,1,1,1,1,1,1,1,1,1,1,1,1,1,1,1,1,1,1,1,1,1,1,1,1,1,1,1,1,1,1,1,1,1,1,1,1,1,1,1,1,1,1,1,1,1,1,1,7,7,1,1,1,1,1,1,1,1,1,1,1,1,1,1,7,7,7,1,1,1,1,1,1,1,1,1,1,1,1,1,1,1,1,1,1,1,1,1,1,1,1,1,1,1,1,1,1,1,1,1,1,1,1,1,1,1,1,1,1,1,1,1,1,1,1,1,1,1,1,1,1,1,1,1,1,1,1,1,1,1,1,1,7,7,1,1,1,1,1,1,1,1,1,1,1,1,1,1,1,1,1,1,1,1,1,1,1,1,1,1,1,1,1,1,1,1,1,1,1,1,1,1,1,1,1,1,1,1,1,1,1,1,1,1,1,1,1,1,1,1,1,1,1,1
1,1,1,1,1,1,1,1,1,1,1,1,1,1,1,1,1,1,1,1,1,1,1,1,1,1,1,1,1,1,1,1,1,1,1,1,1,1,1,1,1,1,1,1,1,1,1,1,1,1,1,1,1,1,1,1,1,1,1,1,1,1,1,1,1,1,1,1,7,7,1,1,1,1,1,1,1,1,1,1,1,1,1,1,7,7,7,1,1,1,1,1,1,1,1,1,1,1,1,1,1,1,1,1,1,1,1,1,1,1,1,1,1,1,1,1,1,1,1,1,1,1,1,1,1,1,1,1,1,1,1,1,1,1,1,1,1,1,1,1,1,1,1,1,1,1,1,1,1,1,1,1,7,7,1,1,1,1,1,1,1,1,1,1,1,1,1,1,1,1,1,1,1,1,1,1,1,1,1,1,1,1,1,1,1,1,1,1,1,1,1,1,1,1,1,1,1,1,1,1,1,1,1,1,1,1,1,1,1,1,1,1,1,1
