// 234x13 map
 7, 7, 7, 7, 7, 7, 7, 7, 7, 7, 7, 7, 7, 7, 7, 7, 7, 7, 7, 7, 7, 7, 7, 7, 7, 7, 7, 7, 7, 7, 7, 7, 7, 7, 7, 7, 7, 7, 7, 7, 7, 7, 7, 7, 7, 7, 7, 7, 7, 7, 7, 7, 7, 7, 7, 7, 7, 7, 7, 7, 7, 7, 7, 7, 7, 7, 7, 7, 7, 7, 7, 7, 7, 7, 7, 7, 7, 7, 7, 7, 7, 7, 4, 5, 5, 6, 7, 7, 7, 7, 7, 7, 7, 7, 7, 7, 7, 7, 7, 7, 7, 7, 7, 7, 7, 7, 7, 7, 7, 7, 7, 7, 7, 4, 5, 6, 7, 7, 7, 7, 7, 7, 7, 7, 7, 7, 7, 7, 7, 7, 4, 5, 5, 6, 7, 7, 7, 7, 7, 7, 7, 7, 7, 7, 7, 7, 7, 7, 7, 7, 7, 7, 7, 7, 7, 7, 7, 7, 7, 7, 7, 7, 7, 7, 7, 7, 7, 7, 7, 7, 7, 7, 7, 7, 7, 7, 7, 7, 7, 7, 7, 7, 7, 7, 7, 7, 7, 7, 7, 7, 7, 7, 7, 7, 7, 7, 7, 7, 7, 7, 7, 7, 7, 7, 7, 7, 7, 7, 7, 7, 7, 7, 7, 7
 7, 7, 7, 7, 7, 7, 7, 7, 7, 7, 7, 7, 7, 7, 7, 7, 7, 7, 7, 4, 5, 6, 7, 7, 7, 7, 7, 4, 5, 5, 5, 6, 7, 7, 7, 7, 7, 4, 5, 5, 6, 7, 7, 7, 7, 7, 7, 7, 7, 7, 7, 7, 7, 7, 7, 4, 5, 6, 7, 7, 7, 7, 7, 7, 7, 7, 4, 5, 6, 7, 7, 7, 7, 4, 5, 5, 5, 6, 7, 7, 7, 7,20,21,21,22, 7, 7, 7, 7, 7, 7, 7, 7, 7, 7, 7, 7, 7, 7, 7, 4, 5, 6, 7, 7, 7, 7, 7, 7, 7, 7, 7,20,21,22, 7, 7, 7, 7, 7, 4, 5, 5, 5, 6, 7, 7, 7, 7,20,21,21,22, 7, 7, 7, 7, 7, 7, 7, 7, 7, 7, 7, 7, 7, 7, 7, 7, 7, 7, 7, 7, 7, 7, 7, 7, 7, 7, 7, 7, 4, 5, 6, 7, 7, 7, 7, 7, 7, 7, 7, 7, 7, 7, 7, 7, 7, 4, 5, 5, 6, 7, 7, 7, 7, 7, 7, 7, 7, 7, 7, 7, 7, 7, 7,12, 7, 7, 7, 7, 7, 7, 7, 7, 7, 7, 7, 7, 7, 7, 7, 7
 7, 7, 7, 7, 7, 7, 7, 4, 5, 6, 7, 7, 7, 7, 7, 7, 7, 7, 7,20,21,22, 7, 7, 7, 7, 7,20,21,21,21,22, 7, 7, 7, 7, 7,20,21,21,22, 7, 7, 7, 7, 7, 7, 7, 7, 7, 7, 7, 7, 7, 7,20,21,22, 7, 7, 7, 7, 7, 7, 7, 7,20,21,22, 7, 7, 7, 7,20,21,21,21,22, 7, 7, 7, 7, 7, 7, 7, 7, 7, 7, 7, 7, 7, 7, 7, 7, 7, 7, 7, 7, 7, 7, 7,20,21,22, 7, 7, 7, 7, 7, 7, 7, 7, 7, 7, 7, 7, 7, 7, 7, 7, 7,20,21,21,21,22, 7, 7, 7, 7, 7, 7, 7, 7, 7, 7, 7, 7, 7, 7, 7, 7, 7, 7, 7, 7, 7, 7, 7, 7, 7, 4, 5, 6, 7, 7, 7, 7, 7, 7, 7, 7,20,21,22, 7, 7, 7, 7, 7, 4, 5, 5, 5, 6, 7, 7, 7, 7,20,21,21,22, 7, 7, 7, 7, 7, 7, 7, 7, 7, 7, 7, 7, 7, 7,28, 7, 4, 5, 6, 7, 7, 7, 7, 7, 7, 7, 7, 7, 7, 7, 7
 7, 7, 7, 7, 7, 7, 7,20,21,22, 7, 7, 7, 7, 7, 7, 7, 7, 7, 7, 7, 7, 7, 7, 7, 7, 7, 7, 7, 7, 7, 7, 7, 7, 7, 7, 7, 7, 7, 7, 7, 7, 7, 7, 7, 7, 7, 7, 7, 7, 7, 7, 7, 7, 7, 7, 7, 7, 7, 7, 7, 7, 7, 7, 7, 7, 7, 7, 7, 7, 7, 7, 7, 7, 7, 7, 7, 7, 2, 2, 2, 2, 2, 2, 2, 2, 7, 7, 7, 2, 2, 2, 3, 7, 7, 7, 7, 7, 7, 7, 7, 7, 7, 7, 7, 7, 7,33, 7, 7, 7, 7, 7, 7, 7, 7, 7, 7, 7, 2, 2, 2, 7, 7, 7, 7, 2, 3, 3, 2, 7, 7, 7, 7, 7, 7, 7, 7, 7, 7, 7, 7, 7, 7, 7, 7, 7, 7, 7, 7, 7,20,21,22, 7, 7, 7, 7, 7, 7, 7, 7, 7, 7, 7, 7, 7, 7, 7, 7,20,21,21,21,22, 7, 7, 7, 7, 7, 7, 7, 7, 7, 7, 7, 7, 0, 0, 7, 7, 7, 7, 7, 7, 7, 7,28, 7,20,21,22, 7, 7, 7, 7, 7, 7, 7, 7, 7, 7, 7, 7
 7, 7, 7, 7, 7, 7, 7, 7, 7, 7, 7, 7, 7, 7, 7, 7, 7, 7, 7, 7, 7, 7, 3, 7, 7, 7, 7, 7, 7, 7, 7, 7, 7, 7, 7, 7, 7, 7, 7, 7, 7, 7, 7, 7, 7, 7, 7, 7, 7, 7, 7, 7, 7, 7, 7, 7, 7, 7, 7, 7, 7, 7, 7, 7, 7, 7, 7, 7, 7, 7, 7, 7, 7, 7, 7, 7, 7, 7, 7, 7, 7, 7, 7, 7, 7, 7, 7, 7, 7, 7, 7, 7, 7, 7, 7, 7, 7, 7, 7, 7, 7, 7, 7, 7, 7, 7, 7, 7, 7, 7, 7, 7, 7, 7, 7, 7, 7, 7, 7, 7, 7, 7, 7, 7, 7, 7, 7, 7, 7, 7, 7, 7, 7, 7, 7, 7, 7, 7, 7, 7, 7, 7, 7, 7, 7, 7, 7, 7, 7, 7, 7, 7, 7, 7, 7, 7, 7, 7, 7, 7, 7, 7, 7, 7, 7, 7, 7, 7, 7, 7, 7, 7, 7, 7, 7, 7, 7, 7, 7, 7, 7, 7, 7, 7, 7, 7, 0, 0, 0, 7, 7, 7, 7, 7, 7, 7, 7,28, 7, 7, 7, 7, 7, 7, 7, 7, 7, 7, 7, 7, 7, 7, 7, 7
 7, 7, 7, 7, 7, 7, 7, 7, 7, 7, 7, 7, 7, 7, 7, 7, 7, 7, 7, 7, 7, 7, 7, 7, 7, 7, 7, 7, 7, 7, 7, 7, 7, 7, 7, 7, 7, 7, 7, 7, 7, 7, 7, 7, 7, 7, 7, 7, 7, 7, 7, 7, 7, 7, 7, 7, 7, 7, 7, 7, 7, 7, 7, 7, 7, 7, 7, 7, 7, 7, 7, 7, 7, 7, 7, 7, 7, 7, 7, 7, 7, 7, 7, 7, 7, 7, 7, 7, 7, 7, 7, 7, 7, 7, 7, 7, 7, 7, 7, 7, 7, 7, 7, 7, 7, 7, 7, 7, 7, 7, 7, 7, 7, 7, 7, 7, 7, 7, 7, 7, 7, 7, 7, 7, 7, 7, 7, 7, 7, 7, 7, 7, 7, 7, 7, 7, 7, 7, 7, 7, 7, 7, 7, 7, 7, 7, 7, 7, 7, 7, 7, 7, 7, 7, 7, 7, 7, 7, 7, 7, 7, 7, 7, 7, 7, 7, 7, 7, 7, 7, 7, 7, 7, 7, 7, 7, 7, 7, 7, 7, 7, 7, 7, 7, 7, 0, 0, 0, 0, 7, 7, 7, 7, 7, 7, 7, 7,28, 7, 7, 7, 7, 7, 7, 7, 7, 7, 7, 7, 7, 7, 7, 7, 7
 7, 7, 7, 7, 7, 7, 7, 7, 7, 7, 7, 7, 7, 7, 7, 7, 7, 7, 7, 7, 7, 7, 7, 7, 7, 7, 7, 7, 7, 7, 7, 7, 7, 7, 7, 7, 7, 7, 7, 7, 7, 7, 7, 7, 7, 7, 7, 7, 7, 7, 7, 7, 7, 7, 7, 7, 7, 7, 7, 7, 7, 7, 7, 7,35, 7, 7, 7, 7, 7, 7, 7, 7, 7, 7, 7, 7, 7, 7, 7, 7, 7, 7, 7, 7, 7, 7, 7, 7, 7, 7, 7, 7, 7, 7, 7, 7, 7, 7, 7, 7, 7, 7, 7, 7, 7, 7, 7, 7, 7, 7, 7, 7, 7, 7, 7, 7, 7, 7, 7, 7, 7, 7, 7, 7, 7, 7, 7, 7, 7, 7, 7, 7, 7, 7, 7, 7, 7, 7, 7, 7, 7, 7, 7, 7, 7, 7, 7, 7, 7, 7, 7, 7, 7, 7, 7, 7, 7, 7, 7, 7, 7, 7, 7, 7, 7, 7, 7, 7, 7, 7, 7, 7, 7, 7, 7, 7, 7, 7, 7, 7, 7, 7, 7, 0, 0, 0, 0, 0, 7, 7, 7, 7, 7, 7, 7, 7,28, 7, 7, 7, 7,13,13,13, 7, 7, 7, 7, 7, 7, 7, 7, 7
 7, 7, 7, 7, 7, 7, 7, 7, 7, 7, 7, 7, 7, 7, 7, 7, 7, 7, 7, 7, 2,33, 2, 3, 2, 7, 7, 7, 7, 7, 7, 7, 7, 7, 7, 7, 7, 7, 7, 7, 7, 7, 7, 7, 7,10,11, 7, 7, 7, 7, 7, 7, 7, 7, 7,10,11, 7, 7, 7, 7, 7, 7, 7, 7, 7, 7, 7, 7, 7, 7, 7, 7, 7, 7, 2, 3, 2, 7, 7, 7, 7, 7, 7, 7, 7, 7, 7, 7, 7, 7,36, 7, 7, 7, 7, 2,34, 7, 7, 7, 7, 7, 3, 7, 7, 3, 7, 7, 3, 7, 7, 7, 7, 7, 2, 7, 7, 7, 7, 7, 7, 7, 7, 7, 7, 2, 2, 7, 7, 7, 7, 7, 7, 0, 7, 7, 0, 7, 7, 7, 7, 7, 7, 7, 7, 7, 7, 7, 0, 0, 7, 7, 0, 7, 7, 7, 7, 7, 7, 7, 7, 7, 7, 7, 7, 2, 2, 3, 2, 7, 7, 7, 7, 7, 7, 7, 7, 7, 7, 7, 7, 0, 0, 0, 0, 0, 0, 7, 7, 7, 7, 7, 7, 7, 7,28, 7, 7, 7, 7,29, 2,31, 7, 7, 7, 7, 7, 7, 7, 7, 7
 7, 7, 8, 7, 7, 7, 7, 7, 7, 7, 7, 7, 7, 7, 7, 7, 7, 7, 7, 7, 7, 7, 7, 7, 7, 7, 7, 7, 7, 7, 7, 7, 7, 7, 7, 7, 7, 7,10,11, 7, 7, 7, 7, 7,26,27, 7, 7, 8, 7, 7, 7, 7, 7, 7,26,27, 7, 7, 7, 7, 7, 7, 7, 7, 7, 7, 7, 7, 7, 7, 7, 7, 7, 7, 7, 7, 7, 7, 7, 7, 7, 7, 7, 7, 7, 7, 7, 7, 7, 7, 7, 7, 7, 7, 8, 7, 7, 7, 7, 7, 7, 7, 7, 7, 7, 7, 7, 7, 7, 7, 7, 7, 7, 7, 7, 7, 7, 7, 7, 7, 7, 7, 7, 7, 7, 7, 7, 7, 7, 7, 7, 7, 0, 0, 7, 7, 0, 0, 7, 7, 7, 7, 8, 7, 7, 7, 7, 0, 0, 0, 7, 7, 0, 0, 7, 7, 7, 7, 7, 7, 7, 7, 7, 7, 7, 7, 7, 7, 7, 7, 7, 7, 7, 7, 7, 7, 7, 7, 7, 7, 0, 0, 0, 0, 0, 0, 0, 7, 7, 7, 7, 8, 7, 7, 7,28, 7, 7, 7,13,15,15,15,13, 7, 7, 7, 7, 7, 7, 7, 7
 7,23,24,25, 7, 7, 7, 7, 7, 7, 7, 7, 7, 7, 7, 7, 7, 8, 7, 7, 7, 7, 7, 7, 7, 7, 7, 7,10,11, 7, 7, 7, 7, 7, 7, 7, 7,26,27, 7, 7, 7, 7, 7,26,27, 7,23,24,25, 7, 7, 7, 7, 7,26,27, 7, 7, 7, 7, 7, 7, 8, 7, 7, 7, 7, 7, 7, 7, 7, 7, 7, 7, 7, 7, 7, 7, 7, 7, 7, 7, 7, 7, 7, 7, 7, 7, 7, 7, 7, 7, 7,23,24,25, 7, 7, 7, 7, 7, 7, 7, 7, 7, 7, 7, 7, 7, 8, 7, 7, 7, 7, 7, 7, 7, 7, 7, 7, 7, 7, 7, 7, 7, 7, 7, 7, 7, 7, 7, 0, 0, 0, 7, 7, 0, 0, 0, 7, 7,23,24,25, 7, 7, 0, 0, 0, 0, 7, 7, 0, 0, 0, 7, 7, 7, 8, 7,10,11, 7, 7, 7, 7, 7, 7, 7, 7, 7, 7, 7, 7, 7, 7,10,11, 7, 0, 0, 0, 0, 0, 0, 0, 0, 7, 7, 7,23,24,25, 7, 7,28, 7, 7, 7, 2, 2,14, 2, 2, 7, 7, 8, 7, 7, 7, 7, 7
23,24, 9,24,25, 7, 7, 7, 7, 7,17,18,18,18,18,19,23,24,25, 7, 7, 7, 7,17,18,19, 7, 7,26,27, 7, 7, 7, 7, 7, 7, 7, 7,26,27, 7,17,18,18,19,26,27,23,24, 9,24,25, 7, 7, 7, 7,26,27,17,18,18,18,19,23,24,25, 7, 7, 7, 7,17,18,19, 7, 7, 7, 7, 7, 7, 7, 7, 7, 7, 7, 7, 7, 7,17,18,18,19, 7, 7, 7,23,24, 9,24,25, 7, 7, 7, 7, 7, 7,17,18,18,18,19,23,24,25, 7, 7, 7, 7, 7, 7, 7, 7, 7, 7, 7, 7, 7, 7, 7, 7, 7, 7, 7, 0, 0, 0, 0,18,18, 0, 0, 0, 0,23,24, 9,24,25, 0, 0, 0, 0, 0, 7, 7, 0, 0, 0, 0,19,23,24,25,26,27, 7, 7,17,18,19, 7, 7, 7, 7, 7, 7, 7, 7, 7,26,27, 0, 0, 0, 0, 0, 0, 0, 0, 0, 7, 7,23,24, 9,24,25, 7, 0, 7, 7, 7, 2, 2,30, 2, 2,19,23,24,25, 7, 7, 7, 7
 1, 1, 1, 1, 1, 1, 1, 1, 1, 1, 1, 1, 1, 1, 1, 1, 1, 1, 1, 1, 1, 1, 1, 1, 1, 1, 1, 1, 1, 1, 1, 1, 1, 1, 1, 1, 1, 1, 1, 1, 1, 1, 1, 1, 1, 1, 1, 1, 1, 1, 1, 1, 1, 1, 1, 1, 1, 1, 1, 1, 1, 1, 1, 1, 1, 1, 1, 1, 7, 7, 1, 1, 1, 1, 1, 1, 1, 1, 1, 1, 1, 1, 1, 1, 7, 7, 7, 1, 1, 1, 1, 1, 1, 1, 1, 1, 1, 1, 1, 1, 1, 1, 1, 1, 1, 1, 1, 1, 1, 1, 1, 1, 1, 1, 1, 1, 1, 1, 1, 1, 1, 1, 1, 1, 1, 1, 1, 1, 1, 1, 1, 1, 1, 1, 1, 1, 1, 1, 1, 1, 1, 1, 1, 1, 1, 1, 1, 1, 1, 1, 1, 1, 7, 7, 1, 1, 1, 1, 1, 1, 1, 1, 1, 1, 1, 1, 1, 1, 1, 1, 1, 1, 1, 1, 1, 1, 1, 1, 1, 1, 1, 1, 1, 1, 1, 1, 1, 1, 1, 1, 1, 1, 1, 1, 1, 1, 1, 1, 1, 1, 1, 1, 1, 1, 1, 1, 1, 1, 1, 1, 1, 1, 1, 1
 1, 1, 1, 1, 1, 1, 1, 1, 1, 1, 1, 1, 1, 1, 1, 1, 1, 1, 1, 1, 1, 1, 1, 1, 1, 1, 1, 1, 1, 1, 1, 1, 1, 1, 1, 1, 1, 1, 1, 1, 1, 1, 1, 1, 1, 1, 1, 1, 1, 1, 1, 1, 1, 1, 1, 1, 1, 1, 1, 1, 1, 1, 1, 1, 1, 1, 1, 1, 7, 7, 1, 1, 1, 1, 1, 1, 1, 1, 1, 1, 1, 1, 1, 1, 7, 7, 7, 1, 1, 1, 1, 1, 1, 1, 1, 1, 1, 1, 1, 1, 1, 1, 1, 1, 1, 1, 1, 1, 1, 1, 1, 1, 1, 1, 1, 1, 1, 1, 1, 1, 1, 1, 1, 1, 1, 1, 1, 1, 1, 1, 1, 1, 1, 1, 1, 1, 1, 1, 1, 1, 1, 1, 1, 1, 1, 1, 1, 1, 1, 1, 1, 1, 7, 7, 1, 1, 1, 1, 1, 1, 1, 1, 1, 1, 1, 1, 1, 1, 1, 1, 1, 1, 1, 1, 1, 1, 1, 1, 1, 1, 1, 1, 1, 1, 1, 1, 1, 1, 1, 1, 1, 1, 1, 1, 1, 1, 1, 1, 1, 1, 1, 1, 1, 1, 1, 1, 1, 1, 1, 1, 1, 1, 1, 1
//,Texture
T Assets/tiles.png
//,Items spritePath
I Assets/items.png
// collision blocks
U 1 10 11 26 27 2 3 0 33 34 35 36 37
//,what blocks turn into another, element[i] turns into element[lenght-1-i] so input accordingly!
B 2 3 33 34 35 37 36 7 0 0 7 0 0 7
// Enemies
E G Assets/NPC.png X 8 10 R
E G Assets/NPC.png X 33 10 L
E G Assets/NPC.png X 51 10 L
E G Assets/NPC.png X 53 10 L
E G Assets/NPC.png X 82 2 L
E G Assets/NPC.png X 84 2 L
E G Assets/NPC.png X 99 10 L
E G Assets/NPC.png X 101 10 L
E G Assets/NPC.png X 103 10 L
E K Assets/NPC.png X 111 10 L
E G Assets/NPC.png X 118 10 L
E G Assets/NPC.png X 120 10 L
E G Assets/NPC.png X 128 10 L
E G Assets/NPC.png X 130 10 L
E G Assets/NPC.png X 132 10 L
E G Assets/NPC.png X 134 10 L
E G Assets/NPC.png X 180 10 L
E G Assets/NPC.png X 182 10 L
//,Starting block
S 2 10
//,Source Rects for each tile value
R 0 0 0 16 16
R 1 16 0 16 16
R 2 32 0 16 16
R 3 48 0 16 16
R 4 64 0 16 16
R 5 80 0 16 16
R 6 96 0 16 16
R 7 112 0 16 16
R 8 128 0 16 16
R 9 144 0 16 16
R 10 160 0 16 16
R 11 176 0 16 16
R 12 192 0 16 16
R 13 208 0 16 16
R 14 224 0 16 16
R 15 240 0 16 16
R 16 256 0 16 16
R 17 16 16 16 16
R 18 32 16 16 16
R 19 48 16 16 16
R 20 64 16 16 16
R 21 80 16 16 16
R 22 96 16 16 16
R 23 112 16 16 16
R 24 128 16 16 16
R 25 144 16 16 16
R 26 160 16 16 16
R 27 176 16 16 16
R 28 192 16 16 16
R 29 208 16 16 16
R 30 224 16 16 16
R 31 240 16 16 16
R 32 256 16 16 16
R 33 48 0 16 16
R 34 32 0 16 16
R 35 112 0 16 16
R 36 32 0 16 16
R 37 32 0 16 16